1111111111111
100000000E001
100C000000001
100000000P001
1111111111111